1111111111111111111111111
1P000000000000000000000C1
10000C111110C001110000001
11110011111000011100C0001
1E0000000000000C0000000C1
1111111111111111111111111
