1111111111111111111111111
1C00000C0000C00C11CC10CE1
1110C01111111011110000011
100010C000C0C000CC0010011
1P001C00C00000C000001C0C1
1111111111111111111111111
