11111111111111
1P000000010001
11111000000001
10000000000001
100000000C0001
10000011111111
10000000000001
101000000000E1
11111111111111